10 6
1111111111111111111111
1000001100000000000001
1000100000000000001101
1000100000000000000001
1000111110001111000111
1101111110001111000111
1101111110001111000111
1100000000000000000001
1111111111111111111111