3 4
111111111
100000001
100000001
100010001
101110101
100000001
111111111
